Sergio Romero	Goal Keeper	Argentina	Monaco
Mariano Andújar	Goal Keeper	Argentina	Catania
Agustín Orión	Goal Keeper	Argentina	Boca Juniors
Martín Demichelis	Defender	Argentina	Manchester City
Pablo Zabaleta	Defender	Argentina	Manchester City
Federico Fernández	Defender	Argentina	Napoli
Marcos Rojo	Defender	Argentina	Sporting CP
Ezequiel Garay	Defender	Argentina	Benfica
Nicolás Otamendi	Defender	Argentina	Atlético Mineiro
Hugo Campagnaro	Defender	Argentina	Internazionale
José María Basanta	Defender	Argentina	Monterrey
Javier Mascherano	Midfielder	Argentina	Barcelona
Maxi Rodríguez	Midfielder	Argentina	Newell's Old Boys
Fernando Gago	Midfielder	Argentina	Boca Juniors
Ángel di María	Midfielder	Argentina	Real Madrid
Éver Banega	Midfielder	Argentina	Newell's Old Boys
José Ernesto Sosa	Midfielder	Argentina	Atlético Madrid
Lucas Biglia	Midfielder	Argentina	Lazio
Augusto Fernández	Midfielder	Argentina	Celta Vigo
Ricardo Álvarez	Midfielder	Argentina	Internazionale
Enzo Pérez	Midfielder	Argentina	Benfica
Lionel Messi	Forward	Argentina	Barcelona
Sergio Agüero	Forward	Argentina	Manchester City
Gonzalo Higuaín	Forward	Argentina	Napoli
Ezequiel Lavezzi	Forward	Argentina	Paris Saint-Germain
Rodrigo Palacio	Forward	Argentina	Internazionale
Eugene Galeković	Goal Keeper	Australia	Adelaide United
Mathew Ryan	Goal Keeper	Australia	Club Brugge
Mitchell Langerak	Goal Keeper	Australia	Borussia Dortmund
Mark Birighitti	Goal Keeper	Australia	Newcastle Jets
Luke Wilkshire	Defender	Australia	Dynamo Moscow
Matthew Špiranović	Defender	Australia	Western Sydney Wanderers
Ryan McGowan	Defender	Australia	Shandong Luneng Taishan
Ivan Franjić	Defender	Australia	Brisbane Roar
Jason Davidson	Defender	Australia	Heracles Almelo
Curtis Good	Defender	Australia	Dundee United
Alex Wilkinson	Defender	Australia	Jeonbuk Hyundai Motors
Bailey Wright	Defender	Australia	Preston North End
Mark Bresciano	Midfielder	Australia	Al-Gharafa
Matt McKay	Midfielder	Australia	Brisbane Roar
Mile Jedinak (captain)	Midfielder	Australia	Crystal Palace
Mark Milligan	Midfielder	Australia	Melbourne Victory
Dario Vidošić	Midfielder	Australia	Sion
Tommy Oar	Midfielder	Australia	Utrecht
James Holland	Midfielder	Australia	Austria Wien
James Troisi	Midfielder	Australia	Atalanta
Tom Rogić	Midfielder	Australia	Celtic
Adam Sarota	Midfielder	Australia	Utrecht
Oliver Bozanic	Midfielder	Australia	Luzern
Joshua Brillante	Midfielder	Australia	Newcastle Jets
Massimo Luongo	Midfielder	Australia	Swindon Town
Ben Halloran	Midfielder	Australia	Fortuna Düsseldorf
Tim Cahill	Forward	Australia	New York Red Bulls
Joshua Kennedy	Forward	Australia	Nagoya Grampus
Mathew Leckie	Forward	Australia	FSV Frankfurt
Adam Taggart	Forward	Australia	Newcastle Jets
Asmir Begović	Goal Keeper	Bosnia and Herzegovina	Stoke City
Asmir Avdukić	Goal Keeper	Bosnia and Herzegovina	Borac Banja Luka
Jasmin Fejzić	Goal Keeper	Bosnia and Herzegovina	VfR Aalen
Dejan Bandović	Goal Keeper	Bosnia and Herzegovina	Sarajevo
Emir Spahić	Defender	Bosnia and Herzegovina	Bayer Leverkusen
Mensur Mujdža	Defender	Bosnia and Herzegovina	SC Freiburg
Avdija Vršajević	Defender	Bosnia and Herzegovina	Hajduk Split
Ognjen Vranješ	Defender	Bosnia and Herzegovina	Elazığspor
Ermin Bičakčić	Defender	Bosnia and Herzegovina	Eintracht Braunschweig
Ervin Zukanović	Defender	Bosnia and Herzegovina	Gent
Toni Šunjić	Defender	Bosnia and Herzegovina	Zorya Luhansk
Sead Kolašinac	Defender	Bosnia and Herzegovina	Schalke 04
Zvjezdan Misimović	Midfielder	Bosnia and Herzegovina	Guizhou Renhe
Miralem Pjanić	Midfielder	Bosnia and Herzegovina	Roma
Senijad Ibričić	Midfielder	Bosnia and Herzegovina	Kayseri Erciyesspor
Sejad Salihović	Midfielder	Bosnia and Herzegovina	1899 Hoffenheim
Haris Medunjanin	Midfielder	Bosnia and Herzegovina	Gaziantepspor
Senad Lulić	Midfielder	Bosnia and Herzegovina	Lazio
Adnan Zahirović	Midfielder	Bosnia and Herzegovina	VfL Bochum
Miroslav Stevanović	Midfielder	Bosnia and Herzegovina	Alavés
Muhamed Bešić	Midfielder	Bosnia and Herzegovina	Ferencváros
Izet Hajrović	Midfielder	Bosnia and Herzegovina	Galatasaray
Zoran Kvržić	Midfielder	Bosnia and Herzegovina	Rijeka
Anel Hadžić	Midfielder	Bosnia and Herzegovina	Sturm Graz
Tino-Sven Sušić	Midfielder	Bosnia and Herzegovina	Hajduk Split
Srđan Stanić	Midfielder	Bosnia and Herzegovina	Željezničar
Edin Džeko	Forward	Bosnia and Herzegovina	Manchester City
Vedad Ibišević	Forward	Bosnia and Herzegovina	VfB Stuttgart
Ermin Zec	Forward	Bosnia and Herzegovina	Gençlerbirliği
Edin Višća	Forward	Bosnia and Herzegovina	İstanbul BB
Thibaut Courtois	Goal Keeper	Belgium	Atlético Madrid
Simon Mignolet	Goal Keeper	Belgium	Liverpool
Sammy Bossut[50]	Goal Keeper	Belgium	Zulte Waregem
Koen Casteels	Goal Keeper	Belgium	1899 Hoffenheim
Daniel Van Buyten	Defender	Belgium	Bayern Munich
Vincent Kompany	Defender	Belgium	Manchester City
Jan Vertonghen	Defender	Belgium	Tottenham Hotspur
Thomas Vermaelen	Defender	Belgium	Arsenal
Toby Alderweireld	Defender	Belgium	Atlético Madrid
Nicolas Lombaerts	Defender	Belgium	Zenit Saint Petersburg
Anthony Vanden Borre	Defender	Belgium	Anderlecht
Laurent Ciman	Defender	Belgium	Standard Liège
Mousa Dembélé	Midfielder	Belgium	Tottenham Hotspur
Marouane Fellaini	Midfielder	Belgium	Manchester United
Axel Witsel	Midfielder	Belgium	Zenit Saint Petersburg
Kevin Mirallas	Midfielder	Belgium	Everton
Eden Hazard	Midfielder	Belgium	Chelsea
Steven Defour	Midfielder	Belgium	Porto
Kevin De Bruyne	Midfielder	Belgium	VfL Wolfsburg
Nacer Chadli	Midfielder	Belgium	Tottenham Hotspur
Adnan Januzaj	Midfielder	Belgium	Manchester United
Romelu Lukaku	Forward	Belgium	Everton
Dries Mertens	Forward	Belgium	Napoli
Divock Origi	Forward	Belgium	Lille
Júlio César	Goal Keeper	Brazil	Toronto FC
Jefferson	Goal Keeper	Brazil	Botafogo
Victor	Goal Keeper	Brazil	Atlético Mineiro
Daniel Alves	Defender	Brazil	Barcelona
Maicon	Defender	Brazil	Roma
Thiago Silva (captain)	Defender	Brazil	Paris Saint-Germain
David Luiz	Defender	Brazil	Chelsea
Marcelo	Defender	Brazil	Real Madrid
Dante	Defender	Brazil	Bayern Munich
Maxwell	Defender	Brazil	Paris Saint-Germain
Henrique	Defender	Brazil	Napoli
Ramires	Midfielder	Brazil	Chelsea
Oscar	Midfielder	Brazil	Chelsea
Paulinho	Midfielder	Brazil	Tottenham Hotspur
Hernanes	Midfielder	Brazil	Internazionale
Luiz Gustavo	Midfielder	Brazil	VfL Wolfsburg
Bernard	Midfielder	Brazil	Shakhtar Donetsk
Fernandinho	Midfielder	Brazil	Manchester City
Willian	Midfielder	Brazil	Chelsea
Neymar	Forward	Brazil	Barcelona
Hulk	Forward	Brazil	Zenit Saint Petersburg
Fred	Forward	Brazil	Fluminense
Jô	Forward	Brazil	Atlético Mineiro
Diego Benaglio	Goal Keeper	Switzerland	VfL Wolfsburg
Stephan Lichtsteiner	Defender	Switzerland	Juventus
Reto Ziegler	Defender	Switzerland	Sassuolo
Philippe Senderos	Defender	Switzerland	Valencia
Steve von Bergen	Defender	Switzerland	Young Boys
Michael Lang	Defender	Switzerland	Grasshopper
Tranquillo Barnetta	Midfielder	Switzerland	Eintracht Frankfurt
Gökhan Inler (captain)	Midfielder	Switzerland	Napoli
Haris Seferović	Forward	Switzerland	Real Sociedad
Boubacar Barry	Goal Keeper	Côte d'Ivoire	Lokeren
Sayouba Mandé	Goal Keeper	Côte d'Ivoire	Stabæk
Badra Ali Sangaré	Goal Keeper	Côte d'Ivoire	ASEC Mimosas
Sylvain Gbohouo	Goal Keeper	Côte d'Ivoire	Séwé Sport
Didier Zokora	Defender	Côte d'Ivoire	Trabzonspor
Kolo Touré	Defender	Côte d'Ivoire	Liverpool
Arthur Boka	Defender	Côte d'Ivoire	VfB Stuttgart
Sol Bamba	Defender	Côte d'Ivoire	Trabzonspor
Benjamin Angoua	Defender	Côte d'Ivoire	Valenciennes
Serge Aurier	Defender	Côte d'Ivoire	Toulouse
Ousmane Viera	Defender	Côte d'Ivoire	Çaykur Rizespor
Constant Djakpa	Defender	Côte d'Ivoire	Eintracht Frankfurt
Jean-Daniel Akpa-Akpro	Defender	Côte d'Ivoire	Toulouse
Brice Dja Djédjé	Defender	Côte d'Ivoire	Marseille
Yaya Touré	Midfielder	Côte d'Ivoire	Manchester City
Cheick Tioté	Midfielder	Côte d'Ivoire	Newcastle United
Didier Ya Konan	Midfielder	Côte d'Ivoire	Hannover 96
Max Gradel	Midfielder	Côte d'Ivoire	Saint-Étienne
Serey Die	Midfielder	Côte d'Ivoire	Basel
Mathis Bolly	Midfielder	Côte d'Ivoire	Fortuna Düsseldorf
Ismaël Diomande	Midfielder	Côte d'Ivoire	Saint-Étienne
Didier Drogba	Forward	Côte d'Ivoire	Galatasaray
Salomon Kalou	Forward	Côte d'Ivoire	Lille
Gervinho	Forward	Côte d'Ivoire	Roma
Wilfried Bony	Forward	Côte d'Ivoire	Swansea City
Seydou Doumbia	Forward	Côte d'Ivoire	CSKA Moscow
Lacina Traoré	Forward	Côte d'Ivoire	Everton
Giovanni Sio	Forward	Côte d'Ivoire	Basel
Claudio Bravo	Goal Keeper	Chile	Real Sociedad
Johnny Herrera	Goal Keeper	Chile	Universidad de Chile
Cristopher Toselli	Goal Keeper	Chile	Universidad Católica
Paulo Garcés	Goal Keeper	Chile	O'Higgins
Gonzalo Jara	Defender	Chile	Nottingham Forest
Gary Medel	Defender	Chile	Cardiff City
Mauricio Isla	Defender	Chile	Juventus
Marcos González	Defender	Chile	Unión Española
Eugenio Mena	Defender	Chile	Santos
José Rojas	Defender	Chile	Universidad de Chile
Miiko Albornoz	Defender	Chile	Malmö
Jean Beausejour	Midfielder	Chile	Wigan Athletic
Jorge Valdivia	Midfielder	Chile	Palmeiras
Arturo Vidal	Midfielder	Chile	Juventus
Carlos Carmona	Midfielder	Chile	Atalanta
Rodrigo Millar	Midfielder	Chile	Atlas
José Pedro Fuenzalida	Midfielder	Chile	Colo-Colo
Charles Aránguiz	Midfielder	Chile	Internacional
Marcelo Díaz	Midfielder	Chile	Basel
Felipe Gutiérrez	Midfielder	Chile	Twente
Francisco Silva	Midfielder	Chile	Osasuna
Pablo Hernández	Midfielder	Chile	O'Higgins
Alexis Sánchez	Forward	Chile	Barcelona
Eduardo Vargas	Forward	Chile	Valencia
Mauricio Pinilla	Forward	Chile	Cagliari
Fabián Orellana	Forward	Chile	Celta Vigo
Guy N'dy Assembé	Goal Keeper	Cameroon	Guingamp
Charles Itandje	Goal Keeper	Cameroon	Konyaspor
Sammy N'Djock	Goal Keeper	Cameroon	Fethiyespor
Loïc Feudjou	Goal Keeper	Cameroon	Coton Sport
Nicolas N'Koulou	Defender	Cameroon	Marseille
Aurélien Chedjou	Defender	Cameroon	Galatasaray
Henri Bedimo	Defender	Cameroon	Lyon
Benoit Assou-Ekotto	Defender	Cameroon	Queens Park Rangers
Dany Nounkeu	Defender	Cameroon	Beşiktaş
Gaëtan Bong	Defender	Cameroon	Olympiacos
Allan Nyom	Defender	Cameroon	Granada
Jean-Armel Kana-Biyik	Defender	Cameroon	Rennes
Cedric Djeugoue	Defender	Cameroon	Coton Sport
Jean Makoun	Midfielder	Cameroon	Rennes
Stéphane Mbia	Midfielder	Cameroon	Sevilla
Alex Song	Midfielder	Cameroon	Barcelona
Landry N'Guémo	Midfielder	Cameroon	Bordeaux
Eyong Enoh	Midfielder	Cameroon	Antalyaspor
Joël Matip	Midfielder	Cameroon	Schalke 04
Edgar Salli	Midfielder	Cameroon	Lens
Raoul Loé	Midfielder	Cameroon	Osasuna
Samuel Eto'o	Forward	Cameroon	Chelsea
Pierre Webó	Forward	Cameroon	Fenerbahçe
Mohammadou Idrissou	Forward	Cameroon	1. FC Kaiserslautern
Maxim Choupo-Moting	Forward	Cameroon	Mainz 05
Vincent Aboubakar	Forward	Cameroon	Lorient
Benjamin Moukandjo	Forward	Cameroon	Nancy
Fabrice Olinga	Forward	Cameroon	Zulte Waregem
Faryd Mondragón	Goal Keeper	Colombia	Deportivo Cali
David Ospina	Goal Keeper	Colombia	Nice
Camilo Vargas	Goal Keeper	Colombia	Santa Fe
Mario Yepes	Defender	Colombia	Atalanta
Luis Amaranto Perea	Defender	Colombia	Cruz Azul
Juan Camilo Zúñiga	Defender	Colombia	Napoli
Pablo Armero	Defender	Colombia	West Ham United
Cristián Zapata	Defender	Colombia	Milan
Carlos Valdés	Defender	Colombia	San Lorenzo
Santiago Arias	Defender	Colombia	PSV Eindhoven
Éder Álvarez Balanta	Defender	Colombia	River Plate
Fredy Guarín	Midfielder	Colombia	Internazionale
Abel Aguilar	Midfielder	Colombia	Toulouse
Carlos Sánchez	Midfielder	Colombia	Elche
Aldo Leão Ramírez	Midfielder	Colombia	Morelia
Juan Guillermo Cuadrado	Midfielder	Colombia	Fiorentina
James Rodríguez	Midfielder	Colombia	Monaco
Edwin Valencia	Midfielder	Colombia	Fluminense
Alexander Mejía	Midfielder	Colombia	Atlético Nacional
Juan Fernando Quintero	Midfielder	Colombia	Porto
Radamel Falcao	Forward	Colombia	Monaco
Teófilo Gutiérrez	Forward	Colombia	River Plate
Jackson Martínez	Forward	Colombia	Porto
Adrián Ramos	Forward	Colombia	Hertha BSC
Carlos Bacca	Forward	Colombia	Sevilla
Víctor Ibarbo	Forward	Colombia	Cagliari
Luis Muriel	Forward	Colombia	Udinese
Keylor Navas	Goal Keeper	Costa Rica	Levante
Patrick Pemberton	Goal Keeper	Costa Rica	Alajuelense
Daniel Cambronero	Goal Keeper	Costa Rica	Herediano
Esteban Alvarado	Goal Keeper	Costa Rica	AZ
Michael Umaña	Defender	Costa Rica	Saprissa
Júnior Díaz	Defender	Costa Rica	Mainz 05
Roy Miller	Defender	Costa Rica	New York Red Bulls
Giancarlo González	Defender	Costa Rica	Columbus Crew
Johnny Acosta	Defender	Costa Rica	Alajuelense
Cristian Gamboa	Defender	Costa Rica	Rosenborg
Óscar Duarte	Defender	Costa Rica	Club Brugge
Heiner Mora	Defender	Costa Rica	Saprissa
Kendall Waston	Defender	Costa Rica	Saprissa
Waylon Francis	Defender	Costa Rica	Columbus Crew
Celso Borges	Midfielder	Costa Rica	AIK
Christian Bolaños	Midfielder	Costa Rica	Copenhagen
Michael Barrantes	Midfielder	Costa Rica	Aalesund
Carlos Hernández	Midfielder	Costa Rica	Wellington Phoenix
José Miguel Cubero	Midfielder	Costa Rica	Herediano
Yeltsin Tejeda	Midfielder	Costa Rica	Saprissa
Ariel Rodríguez	Midfielder	Costa Rica	Alajuelense
Esteban Granados	Midfielder	Costa Rica	Herediano
Diego Calvo	Midfielder	Costa Rica	Vålerenga
Hansell Arauz	Midfielder	Costa Rica	Saprissa
Álvaro Saborío	Forward	Costa Rica	Real Salt Lake
Bryan Ruiz	Forward	Costa Rica	PSV Eindhoven
Randall Brenes	Forward	Costa Rica	Cartaginés
Joel Campbell	Forward	Costa Rica	Olympiacos
Marco Ureña	Forward	Costa Rica	Kuban Krasnodar
Jairo Arrieta	Forward	Costa Rica	Columbus Crew
Manuel Neuer	Goal Keeper	Germany	Bayern Munich
Ron-Robert Zieler	Goal Keeper	Germany	Hannover 96
Roman Weidenfeller	Goal Keeper	Germany	Borussia Dortmund
Philipp Lahm	Defender	Germany	Bayern Munich
Per Mertesacker	Defender	Germany	Arsenal
Jérôme Boateng	Defender	Germany	Bayern Munich
Mats Hummels	Defender	Germany	Borussia Dortmund
Benedikt Höwedes	Defender	Germany	Schalke 04
Marcel Schmelzer	Defender	Germany	Borussia Dortmund
Kevin Großkreutz	Defender	Germany	Borussia Dortmund
Matthias Ginter	Defender	Germany	SC Freiburg
Shkodran Mustafi	Defender	Germany	Sampdoria
Erik Durm	Defender	Germany	Borussia Dortmund
Bastian Schweinsteiger	Midfielder	Germany	Bayern Munich
Mesut Özil	Midfielder	Germany	Arsenal
Sami Khedira	Midfielder	Germany	Real Madrid
Toni Kroos	Midfielder	Germany	Bayern Munich
Mario Götze	Midfielder	Germany	Bayern Munich
Lars Bender	Midfielder	Germany	Bayer Leverkusen
Julian Draxler	Midfielder	Germany	Schalke 04
Christoph Kramer	Midfielder	Germany	Borussia Mönchengladbach
Miroslav Klose	Forward	Germany	Lazio
Lukas Podolski	Forward	Germany	Arsenal
André Schürrle	Forward	Germany	Chelsea
Marco Reus	Forward	Germany	Borussia Dortmund
Thomas Müller	Forward	Germany	Bayern Munich
Kevin Volland	Forward	Germany	1899 Hoffenheim
Raïs M'Bolhi	Goal Keeper	Algeria	CSKA Sofia
Mohamed Zemmamouche	Goal Keeper	Algeria	USM Alger
Azzedine Doukha	Goal Keeper	Algeria	USM El Harrach
Cédric Si Mohamed	Goal Keeper	Algeria	CS Constantine
Madjid Bougherra	Defender	Algeria	Lekhwiya
Rafik Halliche	Defender	Algeria	Académica
Djamel Mesbah	Defender	Algeria	Livorno
Carl Medjani	Defender	Algeria	Valenciennes
Essaïd Belkalem	Defender	Algeria	Watford
Liassine Cadamuro-Bentaïba	Defender	Algeria	Mallorca
Faouzi Ghoulam	Defender	Algeria	Napoli
Nacereddine Khoualed	Defender	Algeria	USM Alger
Aïssa Mandi	Defender	Algeria	Reims
Medhi Lacen	Midfielder	Algeria	Getafe
Adlène Guedioura	Midfielder	Algeria	Crystal Palace
Hassan Yebda	Midfielder	Algeria	Udinese
Foued Kadir	Midfielder	Algeria	Rennes
Mehdi Mostefa	Midfielder	Algeria	Ajaccio
Sofiane Feghouli	Midfielder	Algeria	Valencia
Ryad Boudebouz	Midfielder	Algeria	Bastia
Saphir Taïder	Midfielder	Algeria	Internazionale
Abdelmoumene Djabou	Midfielder	Algeria	Club Africain
Yacine Brahimi	Midfielder	Algeria	Granada
Nabil Bentaleb	Midfielder	Algeria	Tottenham Hotspur
Amir Karaoui	Midfielder	Algeria	ES Sétif
Riyad Mahrez	Midfielder	Algeria	Leicester City
Rafik Djebbour	Forward	Algeria	Nottingham Forest
El Arbi Hillel Soudani	Forward	Algeria	Dinamo Zagreb
Islam Slimani	Forward	Algeria	Sporting Lisbon
Nabil Ghilas	Forward	Algeria	Porto
Máximo Banguera	Goal Keeper	Ecuador	Barcelona
Alexander Domínguez	Goal Keeper	Ecuador	LDU Quito
Adrián Bone	Goal Keeper	Ecuador	El Nacional
Walter Ayoví	Defender	Ecuador	Pachuca
Jorge Guagua	Defender	Ecuador	Emelec
Juan Carlos Paredes	Defender	Ecuador	Barcelona
Frickson Erazo	Defender	Ecuador	Flamengo
Gabriel Achilier	Defender	Ecuador	Emelec
Óscar Bagüí	Defender	Ecuador	Emelec
Cristian Ramírez	Defender	Ecuador	Fortuna Düsseldorf
John Narváez	Defender	Ecuador	Emelec
Édison Méndez	Midfielder	Ecuador	Santa Fe
Segundo Castillo	Midfielder	Ecuador	Al-Hilal
Antonio Valencia	Midfielder	Ecuador	Manchester United
Luis Saritama	Midfielder	Ecuador	Barcelona
Christian Noboa	Midfielder	Ecuador	Dynamo Moscow
Jefferson Montero	Midfielder	Ecuador	Morelia
João Rojas	Midfielder	Ecuador	Cruz Azul
Michael Arroyo	Midfielder	Ecuador	Atlante
Oswaldo Minda	Midfielder	Ecuador	Chivas USA
Renato Ibarra	Midfielder	Ecuador	Vitesse
Pedro Quiñónez	Midfielder	Ecuador	Emelec
Fidel Martínez	Midfielder	Ecuador	Tijuana
Carlos Gruezo	Midfielder	Ecuador	VfB Stuttgart
Ángel Mena	Midfielder	Ecuador	Emelec
Cristian Penilla	Midfielder	Ecuador	Barcelona
Felipe Caicedo	Forward	Ecuador	Al-Jazira
Jaime Ayoví	Forward	Ecuador	Tijuana
Enner Valencia	Forward	Ecuador	Pachuca
Armando Wila	Forward	Ecuador	Universidad Católica
Joe Hart	Goal Keeper	England	Manchester City
Ben Foster	Goal Keeper	England	West Bromwich Albion
Fraser Forster	Goal Keeper	England	Celtic
Glen Johnson	Defender	England	Liverpool
Leighton Baines	Defender	England	Everton
Gary Cahill	Defender	England	Chelsea
Phil Jagielka	Defender	England	Everton
Chris Smalling	Defender	England	Manchester United
Phil Jones	Defender	England	Manchester United
Luke Shaw	Defender	England	Southampton
Steven Gerrard	Midfielder	England	Liverpool
Jack Wilshere	Midfielder	England	Arsenal
Frank Lampard	Midfielder	England	Chelsea
Jordan Henderson	Midfielder	England	Liverpool
Alex Oxlade-Chamberlain	Midfielder	England	Arsenal
James Milner	Midfielder	England	Manchester City
Raheem Sterling	Midfielder	England	Liverpool
Adam Lallana	Midfielder	England	Southampton
Ross Barkley	Midfielder	England	Everton
Daniel Sturridge	Forward	England	Liverpool
Wayne Rooney	Forward	England	Manchester United
Danny Welbeck	Forward	England	Manchester United
Rickie Lambert	Forward	England	Southampton
Iker Casillas (captain)	Goal Keeper	Spain	Real Madrid
Pepe Reina	Goal Keeper	Spain	Napoli
David de Gea	Goal Keeper	Spain	Manchester United
Sergio Ramos	Defender	Spain	Real Madrid
Gerard Piqué	Defender	Spain	Barcelona
Raúl Albiol	Defender	Spain	Napoli
Jordi Alba	Defender	Spain	Barcelona
Juanfran	Defender	Spain	Atlético Madrid
César Azpilicueta	Defender	Spain	Chelsea
Alberto Moreno	Defender	Spain	Sevilla
Daniel Carvajal	Defender	Spain	Real Madrid
Xavi Hernández	Midfielder	Spain	Barcelona
Xabi Alonso	Midfielder	Spain	Real Madrid
Andrés Iniesta	Midfielder	Spain	Barcelona
Cesc Fàbregas	Midfielder	Spain	Barcelona
David Silva	Midfielder	Spain	Manchester City
Sergio Busquets	Midfielder	Spain	Barcelona
Santi Cazorla	Midfielder	Spain	Arsenal
Jesús Navas	Midfielder	Spain	Manchester City
Juan Mata	Midfielder	Spain	Manchester United
Javi Martínez	Midfielder	Spain	Bayern Munich
Koke	Midfielder	Spain	Atlético Madrid
Ander Iturraspe	Midfielder	Spain	Athletic Bilbao
Fernando Torres	Forward	Spain	Chelsea
David Villa	Forward	Spain	Atlético Madrid
Pedro Rodríguez	Forward	Spain	Barcelona
Fernando Llorente	Forward	Spain	Juventus
Álvaro Negredo	Forward	Spain	Manchester City
Diego Costa	Forward	Spain	Atlético Madrid
Hugo Lloris (C)	Goal Keeper	France	Tottenham Hotspur
Mickaël Landreau	Goal Keeper	France	Bastia
Stéphane Ruffier[34]	Goal Keeper	France	Saint-Étienne
Patrice Evra	Defender	France	Manchester United
Bacary Sagna	Defender	France	Arsenal
Mathieu Debuchy	Defender	France	Newcastle United
Mamadou Sakho	Defender	France	Liverpool
Laurent Koscielny	Defender	France	Arsenal
Raphaël Varane	Defender	France	Real Madrid
Eliaquim Mangala	Defender	France	Porto
Lucas Digne	Defender	France	Paris Saint-Germain
Franck Ribéry	Midfielder	France	Bayern Munich
Mathieu Valbuena	Midfielder	France	Marseille
Yohan Cabaye	Midfielder	France	Paris Saint-Germain
Blaise Matuidi	Midfielder	France	Paris Saint-Germain
Moussa Sissoko	Midfielder	France	Newcastle United
Rio Mavuba	Midfielder	France	Lille
Paul Pogba	Midfielder	France	Juventus
Clément Grenier	Midfielder	France	Lyon
Antoine Griezmann	Midfielder	France	Real Sociedad
Karim Benzema	Forward	France	Real Madrid
Olivier Giroud	Forward	France	Arsenal
Loïc Rémy	Forward	France	Newcastle United
Adam Kwarasey	Goal Keeper	Ghana	Strømsgodset
Fatau Dauda	Goal Keeper	Ghana	Orlando Pirates
Steven Adams	Goal Keeper	Ghana	Aduana Stars
Samuel Inkoom	Defender	Ghana	Platanias
Harrison Afful	Defender	Ghana	Espérance
John Boye	Defender	Ghana	Rennes
Jonathan Mensah	Defender	Ghana	Évian
Daniel Opare	Defender	Ghana	Standard Liège
Jerry Akaminko	Defender	Ghana	Eskişehirspor
Rashid Sumaila	Defender	Ghana	Mamelodi Sundowns
Jeff Schlupp	Defender	Ghana	Leicester City
Sulley Muntari	Midfielder	Ghana	Milan
Kwadwo Asamoah	Midfielder	Ghana	Juventus
Michael Essien	Midfielder	Ghana	Milan
Emmanuel Agyemang-Badu	Midfielder	Ghana	Udinese
André Ayew	Midfielder	Ghana	Marseille
Christian Atsu	Midfielder	Ghana	Vitesse
Wakaso Mubarak	Midfielder	Ghana	Rubin Kazan
Mohammed Rabiu	Midfielder	Ghana	Kuban Krasnodar
Albert Adomah	Midfielder	Ghana	Middlesbrough
Kevin-Prince Boateng	Midfielder	Ghana	Schalke 04
Afriyie Acquah	Midfielder	Ghana	Parma
Asamoah Gyan	Forward	Ghana	Al-Ain
Majeed Waris	Forward	Ghana	Valenciennes
Jordan Ayew	Forward	Ghana	Sochaux
David Accam	Forward	Ghana	Helsingborg
Orestis Karnezis	Goal Keeper	Greece	Granada
Stefanos Kapino	Goal Keeper	Greece	Panathinaikos
Panagiotis Glykos	Goal Keeper	Greece	PAOK
Vasilis Torosidis	Defender	Greece	Roma
Loukas Vyntra	Defender	Greece	Levante
Sokratis Papastathopoulos	Defender	Greece	Borussia Dortmund
Giannis Maniatis	Defender	Greece	Olympiacos
José Holebas	Defender	Greece	Olympiacos
Vangelis Moras	Defender	Greece	Hellas Verona
Giorgos Tzavellas	Defender	Greece	PAOK
Kostas Manolas	Defender	Greece	Olympiacos
Giorgos Karagounis (captain)	Midfielder	Greece	Fulham
Kostas Katsouranis	Midfielder	Greece	PAOK
Alexandros Tziolis	Midfielder	Greece	Kayserispor
Giannis Fetfatzidis	Midfielder	Greece	Genoa
Lazaros Christodoulopoulos	Midfielder	Greece	Bologna
Panagiotis Kone	Midfielder	Greece	Bologna
Panagiotis Tachtsidis	Midfielder	Greece	Torino
Andreas Samaris	Midfielder	Greece	Olympiacos
Dimitris Salpingidis	Forward	Greece	PAOK
Giorgos Samaras	Forward	Greece	Celtic
Theofanis Gekas	Forward	Greece	Konyaspor
Kostas Mitroglou	Forward	Greece	Fulham
Noel Valladares (captain)	Goal Keeper	Honduras	Olimpia
Donis Escober	Goal Keeper	Honduras	Olimpia
Luis López	Goal Keeper	Honduras	Real España
Maynor Figueroa	Defender	Honduras	Hull City
Víctor Bernárdez	Defender	Honduras	San Jose Earthquakes
Emilio Izaguirre	Defender	Honduras	Celtic
Osman Chávez	Defender	Honduras	Qingdao Jonoon
Juan Carlos García	Defender	Honduras	Wigan Athletic
Brayan Beckeles	Defender	Honduras	Olimpia
Juan Pablo Montes	Defender	Honduras	Motagua
Wilson Palacios	Midfielder	Honduras	Stoke City
Óscar García	Midfielder	Honduras	Houston Dynamo
Jorge Claros	Midfielder	Honduras	Motagua
Marvin Chávez	Midfielder	Honduras	Chivas USA
Roger Espinoza	Midfielder	Honduras	Wigan Athletic
Mario Martínez	Midfielder	Honduras	Real España
Arnold Peralta	Midfielder	Honduras	Rangers
Luis Garrido	Midfielder	Honduras	Olimpia
Andy Najar	Midfielder	Honduras	Anderlecht
Carlo Costly	Forward	Honduras	Real España
Jerry Bengtson	Forward	Honduras	New England Revolution
Jerry Palacios	Forward	Honduras	Alajuelense
Rony Martínez	Forward	Honduras	Real Sociedad
Stipe Pletikosa	Goal Keeper	Croatia	Rostov
Danijel Subašić	Goal Keeper	Croatia	Monaco
Oliver Zelenika	Goal Keeper	Croatia	NK Lokomotiva
Darijo Srna	Defender	Croatia	Shakhtar Donetsk
Vedran Ćorluka	Defender	Croatia	Lokomotiv Moscow
Danijel Pranjić	Defender	Croatia	Panathinaikos
Dejan Lovren	Defender	Croatia	Southampton
Domagoj Vida	Defender	Croatia	Dynamo Kyiv
Gordon Schildenfeld	Defender	Croatia	Panathinaikos
Šime Vrsaljko	Defender	Croatia	Genoa
Igor Bubnjić	Defender	Croatia	Udinese
Niko Kranjčar	Midfielder	Croatia	Queens Park Rangers
Luka Modrić	Midfielder	Croatia	Real Madrid
Ivan Rakitić	Midfielder	Croatia	Sevilla
Ognjen Vukojević	Midfielder	Croatia	Dynamo Kyiv
Ivan Perišić	Midfielder	Croatia	VfL Wolfsburg
Milan Badelj	Midfielder	Croatia	Hamburger SV
Mateo Kovačić	Midfielder	Croatia	Internazionale
Sammir	Midfielder	Croatia	Getafe
Marcelo Brozović	Midfielder	Croatia	Dinamo Zagreb
Ivan Močinić	Midfielder	Croatia	Rijeka
Mario Pašalić	Midfielder	Croatia	Hajduk Split
Ivica Olić	Forward	Croatia	VfL Wolfsburg
Eduardo	Forward	Croatia	Shakhtar Donetsk
Mario Mandžukić	Forward	Croatia	Bayern Munich
Nikica Jelavić	Forward	Croatia	Hull City
Ante Rebić	Forward	Croatia	Fiorentina
Duje Čop	Forward	Croatia	Dinamo Zagreb
Rahman Ahmadi	Goal Keeper	Iran	Sepahan
Alireza Haghighi	Goal Keeper	Iran	Sporting Covilhã
Daniel Davari	Goal Keeper	Iran	Eintracht Braunschweig
Sosha Makani	Goal Keeper	Iran	Foolad
Alireza Beiranvand	Goal Keeper	Iran	Naft Tehran
Jalal Hosseini	Defender	Iran	Persepolis
Ehsan Hajsafi	Defender	Iran	Sepahan
Khosro Heydari	Defender	Iran	Esteghlal
Pejman Montazeri	Defender	Iran	Umm Salal
Hossein Mahini	Defender	Iran	Persepolis
Mehrdad Pouladi	Defender	Iran	Persepolis
Hashem Beikzadeh	Defender	Iran	Esteghlal
Amir Hossein Sadeghi	Defender	Iran	Esteghlal
Ahmad Alenemeh	Defender	Iran	Naft Tehran
Mohammad Reza Khanzadeh	Defender	Iran	Zob Ahan
Steven Beitashour	Defender	Iran	Vancouver Whitecaps
Javad Nekounam	Midfielder	Iran	Al-Kuwait
Andranik Teymourian	Midfielder	Iran	Esteghlal
Mohammad Reza Khalatbari	Midfielder	Iran	Ajman
Masoud Shojaei	Midfielder	Iran	Las Palmas
Ghasem Haddadifar	Midfielder	Iran	Zob Ahan
Ashkan Dejagah	Midfielder	Iran	Fulham
Reza Haghighi	Midfielder	Iran	Persepolis
Alireza Jahanbakhsh	Midfielder	Iran	NEC
Bakhtiar Rahmani	Midfielder	Iran	Foolad
Karim Ansarifard	Forward	Iran	Tractor Sazi
Reza Ghoochannejhad	Forward	Iran	Charlton Athletic
Reza Norouzi	Forward	Iran	Naft Tehran
Mehdi Sharifi	Forward	Iran	Sepahan
Sardar Azmoun	Forward	Iran	Rubin Kazan
Gianluigi Buffon	Goal Keeper	Italy	Juventus
Salvatore Sirigu	Goal Keeper	Italy	Paris Saint-Germain
Mattia Perin	Goal Keeper	Italy	Genoa
Giorgio Chiellini	Defender	Italy	Juventus
Andrea Barzagli	Defender	Italy	Juventus
Leonardo Bonucci	Defender	Italy	Juventus
Christian Maggio	Defender	Italy	Napoli
Andrea Ranocchia	Defender	Italy	Internazionale
Ignazio Abate	Defender	Italy	Milan
Mattia De Sciglio	Defender	Italy	Milan
Manuel Pasqual	Defender	Italy	Fiorentina
Gabriel Paletta	Defender	Italy	Parma
Matteo Darmian	Defender	Italy	Torino
Andrea Pirlo	Midfielder	Italy	Juventus
Daniele De Rossi	Midfielder	Italy	Roma
Riccardo Montolivo	Midfielder	Italy	Milan
Claudio Marchisio	Midfielder	Italy	Juventus
Alberto Aquilani	Midfielder	Italy	Fiorentina
Thiago Motta	Midfielder	Italy	Paris Saint-Germain
Antonio Candreva	Midfielder	Italy	Lazio
Marco Verratti	Midfielder	Italy	Paris Saint-Germain
Marco Parolo	Midfielder	Italy	Parma
Rômulo	Midfielder	Italy	Verona
Antonio Cassano	Forward	Italy	Parma
Mario Balotelli	Forward	Italy	Milan
Giuseppe Rossi	Forward	Italy	Fiorentina
Alessio Cerci	Forward	Italy	Torino
Mattia Destro	Forward	Italy	Roma
Lorenzo Insigne	Forward	Italy	Napoli
Ciro Immobile	Forward	Italy	Torino
Eiji Kawashima	Goal Keeper	Japan	Standard Liège
Shusaku Nishikawa	Goal Keeper	Japan	Urawa Red Diamonds
Shūichi Gonda	Goal Keeper	Japan	F.C. Tokyo
Atsuto Uchida	Defender	Japan	Schalke 04
Gōtoku Sakai	Defender	Japan	VfB Stuttgart
Yuto Nagatomo	Defender	Japan	Internazionale
Masato Morishige	Defender	Japan	F.C. Tokyo
Yasuyuki Konno	Defender	Japan	Gamba Osaka
Masahiko Inoha	Defender	Japan	Jubilo Iwata
Hiroki Sakai	Defender	Japan	Hannover 96
Maya Yoshida	Defender	Japan	Southampton
Keisuke Honda	Midfielder	Japan	Milan
Yasuhito Endō	Midfielder	Japan	Gamba Osaka
Hiroshi Kiyotake	Midfielder	Japan	1. FC Nürnberg
Shinji Kagawa	Midfielder	Japan	Manchester United
Toshihiro Aoyama	Midfielder	Japan	Sanfrecce Hiroshima
Hotaru Yamaguchi	Midfielder	Japan	Cerezo Osaka
Makoto Hasebe	Midfielder	Japan	1. FC Nürnberg
Shinji Okazaki	Forward	Japan	Mainz 05
Yoichiro Kakitani	Forward	Japan	Cerezo Osaka
Yoshito Ōkubo	Forward	Japan	Kawasaki Frontale
Yuya Osako	Forward	Japan	1860 München
Manabu Saitō	Forward	Japan	Yokohama F. Marinos
Jung Sung-Ryong	Goal Keeper	South Korea	Suwon Bluewings
Kim Seung-Gyu	Goal Keeper	South Korea	Ulsan Hyundai
Lee Bum-Young	Goal Keeper	South Korea	Busan I'Park
Kwak Tae-Hwi	Defender	South Korea	Al-Hilal
Hong Jeong-Ho	Defender	South Korea	FC Augsburg
Kim Young-Gwon	Defender	South Korea	Guangzhou Evergrande
Lee Yong	Defender	South Korea	Ulsan Hyundai
Kim Jin-Su	Defender	South Korea	Albirex Niigata
Kim Chang-Soo	Defender	South Korea	Kashiwa Reysol
Hwang Seok-Ho	Defender	South Korea	Sanfrecce Hiroshima
Yun Suk-Young	Defender	South Korea	Queens Park Rangers
Ki Sung-Yueng	Midfielder	South Korea	Sunderland
Lee Chung-Yong	Midfielder	South Korea	Bolton Wanderers
Koo Ja-Cheol (captain)	Midfielder	South Korea	Mainz 05
Kim Bo-Kyung	Midfielder	South Korea	Cardiff City
Ha Dae-Sung	Midfielder	South Korea	Beijing Guoan
Park Jong-Woo	Midfielder	South Korea	Guangzhou R&F
Han Kook-Young	Midfielder	South Korea	Kashiwa Reysol
Park Chu-Young	Forward	South Korea	Watford
Lee Keun-Ho	Forward	South Korea	Sangju Sangmu
Kim Shin-Wook	Forward	South Korea	Ulsan Hyundai
Ji Dong-Won	Forward	South Korea	FC Augsburg
Son Heung-Min	Forward	South Korea	Bayer Leverkusen
Guillermo Ochoa	Goal Keeper	Mexico	Ajaccio
José de Jesús Corona	Goal Keeper	Mexico	Cruz Azul
Alfredo Talavera	Goal Keeper	Mexico	Toluca
Carlos Salcido	Defender	Mexico	UANL
Rafael Márquez	Defender	Mexico	León
Andrés Guardado	Defender	Mexico	Bayer Leverkusen
Francisco Javier Rodríguez	Defender	Mexico	América
Héctor Moreno	Defender	Mexico	Espanyol
Paul Aguilar	Defender	Mexico	América
Diego Reyes	Defender	Mexico	Porto
Miguel Layún	Defender	Mexico	América
Carlos Peña	Midfielder	Mexico	León
Marco Fabián	Midfielder	Mexico	Cruz Azul
Luis Montes	Midfielder	Mexico	León
Héctor Herrera	Midfielder	Mexico	Porto
Miguel Ángel Ponce	Midfielder	Mexico	Toluca
Isaác Brizuela	Midfielder	Mexico	Toluca
José Juan Vázquez	Midfielder	Mexico	León
Giovani dos Santos	Forward	Mexico	Villarreal
Javier Hernández	Forward	Mexico	Manchester United
Oribe Peralta	Forward	Mexico	Santos Laguna
Raúl Jiménez	Forward	Mexico	América
Alan Pulido	Forward	Mexico	UANL
Vincent Enyeama	Goal Keeper	Nigeria	Lille
Austin Ejide	Goal Keeper	Nigeria	Hapoel Be'er Sheva
Chigozie Agbim	Goal Keeper	Nigeria	Gombe United
Daniel Akpeyi	Goal Keeper	Nigeria	Warri Wolves
Joseph Yobo	Defender	Nigeria	Norwich City
Elderson	Defender	Nigeria	Monaco
Efe Ambrose	Defender	Nigeria	Celtic
Godfrey Oboabona	Defender	Nigeria	Çaykur Rizespor
Azubuike Egwuekwe	Defender	Nigeria	Warri Wolves
Kenneth Omeruo	Defender	Nigeria	Middlesbrough
Juwon Oshaniwa	Defender	Nigeria	Ashdod
Kunle Odunlami	Defender	Nigeria	Sunshine Stars
John Obi Mikel	Midfielder	Nigeria	Chelsea
Ahmed Musa	Midfielder	Nigeria	CSKA Moscow
Sunday Mba	Midfielder	Nigeria	CA Bastia
Ejike Uzoenyi	Midfielder	Nigeria	Enugu Rangers
Ogenyi Onazi	Midfielder	Nigeria	Lazio
Victor Moses	Midfielder	Nigeria	Liverpool
Nnamdi Oduamadi	Midfielder	Nigeria	Brescia
Joel Obi	Midfielder	Nigeria	Parma
Nosa Igiebor	Midfielder	Nigeria	Real Betis
Reuben Gabriel	Midfielder	Nigeria	Waasland-Beveren
Ramon Azeez	Midfielder	Nigeria	Almería
Peter Odemwingie	Forward	Nigeria	Stoke City
Victor Obinna	Forward	Nigeria	Chievo
Emmanuel Emenike	Forward	Nigeria	Fenerbahçe
Shola Ameobi	Forward	Nigeria	Newcastle United
Uche Nwofor	Forward	Nigeria	Heerenveen
Michel Babatunde	Forward	Nigeria	Volyn Lutsk
Michael Uchebo	Forward	Nigeria	Cercle Brugge
Michel Vorm	Goal Keeper	Netherlands	Swansea City
Jasper Cillessen	Goal Keeper	Netherlands	Ajax
Tim Krul	Goal Keeper	Netherlands	Newcastle United
Jeroen Zoet	Goal Keeper	Netherlands	PSV Eindhoven
Ron Vlaar	Defender	Netherlands	Aston Villa
Bruno Martins Indi	Defender	Netherlands	Feyenoord
Daryl Janmaat	Defender	Netherlands	Feyenoord
Stefan de Vrij	Defender	Netherlands	Feyenoord
Patrick van Aanholt	Defender	Netherlands	Vitesse Arnhem
Joël Veltman	Defender	Netherlands	Ajax
Paul Verhaegh	Defender	Netherlands	FC Augsburg
Terence Kongolo	Defender	Netherlands	Feyenoord
Karim Rekik	Defender	Netherlands	PSV Eindhoven
Rafael van der Vaart	Midfielder	Netherlands	Hamburger SV
Wesley Sneijder	Midfielder	Netherlands	Galatasaray
Arjen Robben	Midfielder	Netherlands	Bayern Munich
Nigel de Jong	Midfielder	Netherlands	Milan
Daley Blind	Midfielder	Netherlands	Ajax
Jonathan de Guzmán	Midfielder	Netherlands	Swansea City
Jordy Clasie	Midfielder	Netherlands	Feyenoord
Memphis Depay	Midfielder	Netherlands	PSV Eindhoven
Leroy Fer	Midfielder	Netherlands	Norwich City
Georginio Wijnaldum	Midfielder	Netherlands	PSV Eindhoven
Jean-Paul Boëtius	Midfielder	Netherlands	Feyenoord
Quincy Promes	Midfielder	Netherlands	Twente
Tonny Vilhena	Midfielder	Netherlands	Feyenoord
Dirk Kuyt	Forward	Netherlands	Fenerbahçe
Robin van Persie	Forward	Netherlands	Manchester United
Klaas-Jan Huntelaar	Forward	Netherlands	Schalke 04
Jeremain Lens	Forward	Netherlands	Dynamo Kyiv
Eduardo	Goal Keeper	Portugal	Braga
Rui Patrício	Goal Keeper	Portugal	Sporting CP
Beto	Goal Keeper	Portugal	Sevilla
Bruno Alves	Defender	Portugal	Fenerbahçe
Pepe	Defender	Portugal	Real Madrid
Fábio Coentrão	Defender	Portugal	Real Madrid
João Pereira	Defender	Portugal	Valencia
Ricardo Costa	Defender	Portugal	Valencia
Luís Neto	Defender	Portugal	Zenit Saint Petersburg
André Almeida	Defender	Portugal	Benfica
Raul Meireles	Midfielder	Portugal	Fenerbahçe
Nani	Midfielder	Portugal	Manchester United
João Moutinho	Midfielder	Portugal	Monaco
Miguel Veloso	Midfielder	Portugal	Dynamo Kyiv
Silvestre Varela	Midfielder	Portugal	Porto
Rúben Amorim	Midfielder	Portugal	Benfica
Vieirinha	Midfielder	Portugal	VfL Wolfsburg
William Carvalho	Midfielder	Portugal	Sporting CP
Rafa Silva	Midfielder	Portugal	Braga
Cristiano Ronaldo (captain)	Forward	Portugal	Real Madrid
Hélder Postiga	Forward	Portugal	Lazio
Hugo Almeida	Forward	Portugal	Beşiktaş
Éder	Forward	Portugal	Braga
Igor Akinfeev	Goal Keeper	Russia	CSKA Moscow
Yuri Lodygin	Goal Keeper	Russia	Zenit Saint Petersburg
Sergey Ryzhikov	Goal Keeper	Russia	Rubin Kazan
Sergei Ignashevich	Defender	Russia	CSKA Moscow
Vasili Berezutski	Defender	Russia	CSKA Moscow
Dmitri Kombarov	Defender	Russia	Spartak Moscow
Andrey Yeshchenko	Defender	Russia	Anzhi Makhachkala
Aleksei Kozlov	Defender	Russia	Dynamo Moscow
Vladimir Granat	Defender	Russia	Dynamo Moscow
Georgi Shchennikov	Defender	Russia	CSKA Moscow
Andrei Semyonov	Defender	Russia	Terek Grozny
Igor Denisov	Midfielder	Russia	Dynamo Moscow
Aleksei Ionov	Midfielder	Russia	Dynamo Moscow
Yuri Zhirkov	Midfielder	Russia	Dynamo Moscow
Roman Shirokov	Midfielder	Russia	Krasnodar
Alan Dzagoev	Midfielder	Russia	CSKA Moscow
Denis Glushakov	Midfielder	Russia	Spartak Moscow
Viktor Fayzulin	Midfielder	Russia	Zenit Saint Petersburg
Aleksandr Samedov	Midfielder	Russia	Lokomotiv Moscow
Oleg Shatov	Midfielder	Russia	Zenit Saint Petersburg
Pavel Mogilevets	Midfielder	Russia	Rubin Kazan
Aleksandr Kerzhakov	Forward	Russia	Zenit Saint Petersburg
Aleksandr Kokorin	Forward	Russia	Dynamo Moscow
Maksim Kanunnikov	Forward	Russia	Amkar Perm
Tim Howard	Goal Keeper	United States	Everton
Brad Guzan	Goal Keeper	United States	Aston Villa
Nick Rimando	Goal Keeper	United States	Real Salt Lake
DaMarcus Beasley	Defender	United States	Puebla
Geoff Cameron	Defender	United States	Stoke City
Fabian Johnson	Defender	United States	1899 Hoffenheim
Omar Gonzalez	Defender	United States	Los Angeles Galaxy
Matt Besler	Defender	United States	Sporting Kansas City
Timothy Chandler	Defender	United States	1. FC Nürnberg
John Brooks	Defender	United States	Hertha BSC
DeAndre Yedlin	Defender	United States	Seattle Sounders FC
Michael Bradley	Midfielder	United States	Toronto FC
Jermaine Jones	Midfielder	United States	Beşiktaş
Kyle Beckerman	Midfielder	United States	Real Salt Lake
Alejandro Bedoya	Midfielder	United States	Nantes
Graham Zusi	Midfielder	United States	Sporting Kansas City
Mikkel Diskerud	Midfielder	United States	Rosenborg
Brad Davis	Midfielder	United States	Houston Dynamo
Julian Green	Midfielder	United States	Bayern Munich
Clint Dempsey	Forward	United States	Seattle Sounders FC
Jozy Altidore	Forward	United States	Sunderland
Chris Wondolowski	Forward	United States	San Jose Earthquakes
Aron Jóhannsson	Forward	United States	AZ
Fernando Muslera	Goal Keeper	Uruguay	Galatasaray
Martín Silva	Goal Keeper	Uruguay	Vasco da Gama
Rodrigo Muñoz	Goal Keeper	Uruguay	Libertad
Diego Lugano	Defender	Uruguay	West Bromwich Albion
Maxi Pereira	Defender	Uruguay	Benfica
Diego Godín	Defender	Uruguay	Atlético Madrid
Martín Cáceres	Defender	Uruguay	Juventus
Jorge Fucile	Defender	Uruguay	Porto
Sebastián Coates	Defender	Uruguay	Nacional
José María Giménez	Defender	Uruguay	Atlético Madrid
Alejandro Silva	Defender	Uruguay	Lanús
Diego Pérez	Midfielder	Uruguay	Bologna
Cristian Rodríguez	Midfielder	Uruguay	Atlético Madrid
Walter Gargano	Midfielder	Uruguay	Parma
Álvaro Pereira	Midfielder	Uruguay	São Paulo
Sebastián Eguren	Midfielder	Uruguay	Palmeiras
Egidio Arévalo Ríos	Midfielder	Uruguay	Morelia
Álvaro González	Midfielder	Uruguay	Lazio
Gastón Ramírez	Midfielder	Uruguay	Southampton
Nicolás Lodeiro	Midfielder	Uruguay	Botafogo
Diego Forlán	Forward	Uruguay	Cerezo Osaka
Luis Suárez	Forward	Uruguay	Liverpool
Edinson Cavani	Forward	Uruguay	Paris Saint-Germain
Abel Hernández	Forward	Uruguay	Palermo
Christian Stuani	Forward	Uruguay	Espanyol
